      ###########
      #.........#
#######.........#
#.....#.........#
#.....#.........######
#..*..=....@....&.....
#.....#.........######
#.....#....*....#
#######.........#
      #.........#
      #####.#####
          #.#
          #.#
          #.#
      #####.#####
      #.........#
      #.........#
      #.........#
      #....%....#
      #.........#
      #.........#
      #.........#
      ###########
