...#####..
...#...#..
...=====..
..........
.....@....
..........
%%%%%.....
..........
