                                         #...#                                    #########
                                         #...#                                    #.......#
                                         #...#                                    #.......#
                                         #...#                                    #...*...#
                                         #...#                                    #.......#
                                         #...#                                    #.......#
                                         #...#                              ##########=##########
                                         #.!.#                              #...................#
                                         #...#                              #...................#
                                      ###########                           #...................#
                                      #.........#                           #...................#
                                #######.........#                           #...................#########
                                #.....#.........#                           #...................#.......#
                                #.....#.........#############################........B..........#.......#
                                #..*..=.........&......!........................................&...%...#
                                #.....#.........#############################...................#.......#
                                #.....#.........#                           #...................#.......#
                                #######.........#                           #...................#########
                                      #.........#                           #...................#
                                      #####.#####                           #...................#
                                          #.#                               #...................#
                                          #.#                               #...................#
                                          #.#                               #####################
                                      #####.#####                                   #.@.#
                                      #.........#                                   #...#
                                      #.........#                                   #...#
                                      #.........#                                   #...#
                                      #....%....#                                   #...#
                                      #.........#                                   #...#
                                      #.........#                                   #...#
                                      #.........#                                   #...#
                                      ###########                                   #...#
                                                                                    #...#
                                                                                    #...#
                        #######################################                     #...#
                        #.....................................#                     #...#
                        #.....................................#                     #...#
                        #...#####.....................#####...#                     #...#
                        #...#####.....................#####...#                     #...#
                        #...#####.....................#####...#                     #...#
                        #...#####.....................#####...#                     #...#
                        #.....................................#                     #...#
                        #.....................................#                     #...#
                        #.....................................#                     #...#
                        #.....................................#                     #...#
                        #..............M......................#                     #...#
                        #.....................................#######################...#
                        #...............................................................#
                        #.............................................................!.#
                        #...............................................................#
                        #.....................................###########################
                        #.....................................#
                        #.....................................#
                        #.....................................#
                        #.....................................#
                        #.....................................#
                        #.....................................#
                        #.....................................#
                        #.....................................#
                        #.....................................#
                        #.....................................#
                        #.....................................#
                        #######################################
