                                         #...#                                    #########
                                         #...#                                    #.......#
                                         #...#                                    #.......#
                                         #...#                                    #...*...#
                                         #...#                                    #.......#
                                         #...#                                    #.......#
                                         #...#                              ##########=##########
                                         #.!.#                              #...................#
                                         #...#                              #...................#
                                      ###########                           #...................#
                                      #.........#                           #...................#
                                #######.........#                           #...................#########
                                #.....#.........#                           #...................#.......#
                                #.....#.........#############################........ ..........#.......#
                                #..*..=.........&......!........................................&...%...#
                                #.....#.........#############################...................#.......#
                                #.....#.........#                           #...................#.......#
                                #######.........#                           #...................#########
                                      #.........#                           #...................#
                                      #####.#####                           #...................#
                                          #.#                               #...................#
                                          #.#                               #...................#
                                          #.#                               #########...#########
                                      #####.#####                                   #...#
                                      #.........#                                   #...#
                                      #.........#                                   #...#
                                      #.........#                                   #...#
                                      #....%....#                                   #...#
                                      #.........#                                   #...#
                                      #.........#                                   #...#
                                      #.........#                                   #...#
                                      ###########                                   #...#
                                                                                    #...#
                                                                                    #...#
                                                                                    #...#
                                                                                    #...#
                                                                                    #...#
                                                                                    #...#
                                                                                    #...#
                                                                                    #...#
                                                                                    #...#
                                                                                    #...#
                                ########################                            #...#
                                ###...##........##...###                            #...#
                                ###...##........##...###                            #...#
                                #......=...............#                            #...#
                                #...*..=...........*...#                            #...#
                                #......=...............#                            #...#
                                ###...##........##...###                            #...#
                                ###===##........##...###                            #...#
#################################......................#                            #...#
.........................................M.............#                            #...#
.......................................................##############################...#
......................................................................................!.#
..........................................................................@.............#
.......................................................##################################
.......................................................#
#################################......................#
                                ###===##........##===###
                                ###...##........##...###
                                #......=........=......#
                                #...*..=........=..*...#
                                #......=........=......#
                                ###...##........##...###
                                ###...##........##...###
                                ########################
