                                                              #########
                                                              #.......#
                                                              #.......#
                                                              #...*...#
                                                              #.......#
                                                              #.......#
      ###########                                          #######=#######
      #.........#                                          #.............#
#######.........#                                          #.............#########
#.....#.........#                                          #.............#.......#
#.....#.........############################################....B........#.......#
#..*..=....@....&........................................................&...%...#
#.....#.........############################################.............#.......#
#.....#.........#                                          #.............#.......#
#######.........#                                          #.............#########
      #.........#                                          #.............#
      #####.#####                                          ######...######
          #.#                                                   #...#
          #.#                                                   #...#
          #.#                                                   #...#
      #####.#####                                               #...#
      #.........#                                               #...#
      #.........#                                               #...#
      #.........#                                               #...#
      #....%....#                                               #...#
      #.........#                                               #...#
      #.........#                                               #...#
      #.........#                                               #...#
      ###########                                               #...#
                                                                #...#
                                                                #...#
                                                                #...#
                                                                #...#
                                                                #...#
                                                                #####
                                                           
