         #...#                                    #########
         #...#                                    #.......#
         #...#                                    #.......#
         #...#                                    #...*...#
         #...#                                    #.......#
         #...#                                    #.......#
         #...#                              ##########=##########
         #.!.#                              #...................#
         #...#                              #...................#
      ###########                           #...................#
      #.........#                           #...................#
#######.........#                           #...................#########
#.....#.........#                           #...................#.......#
#.....#.........#############################........B..........#.......#
#..*..=....@....&......!........................................&...%...#
#.....#.........#############################...................#.......#
#.....#.........#                           #...................#.......#
#######.........#                           #...................#########
      #.........#                           #...................#
      #####.#####                           #...................#
          #.#                               #...................#
          #.#                               #...................#
          #.#                               #########...#########
      #####.#####                                   #...#
      #.........#                                   #...#
      #.........#                                   #...#
      #.........#                                   #...#
      #....%....#                                   #...#
      #.........#                                   #...#
      #.........#                                   #...#
      #.........#                                   #...#
      ###########                                   #...#
                                                    #...#
                                                    #...#
                                                    #...#
                                                    #...#
                                                    #...#
                                                    #...#
                                                    #...#
                                                    #...#
                                                    #...#
                                                    #...#
                                                    #...#
                                                    #...#
                                                    #...#
                                                    #...#
                                      ###############...#
                                      ..................#
                                      ................!.#
                                      ..................#
                                      ###################
