                                                           #########
                                                           #.......#
                                                           #.......#
                                                           #...*...#
                                                           #.......#
                                                           #.......#
      ###########                                       #######=#######
      #.........#                                       #.............#
#######.........#                                       #.............#########
#.....#.........#                                       #.............#.......#
#.....#.........#########################################....B........#.......#
#..*..=.........&*.@..................................................&...%...#
#.....#.........#########################################.............#.......#
#.....#.........#                                       #.............#.......#
#######.........#                                       #.............#########
      #.........#                                       #.............#
      #####.#####                                       ######...######
          #.#                                                #...#
          #.#                                                #...#
          #.#                                                #...#
      #####.#####                                            #...#
      #.........#                                            #...#
      #.........#                                            #...#
      #.........#                                            #...#
      #....%....#                                            #...#
      #.........#                                            #...#
      #.........#                                            #...#
      #.........#                                            #...#
      ###########                                            #...#
                                                             #...#
                                                             #...#
                                                             #...#
                                                             #...#
                                                             #...#
                                                             #####
                                                        
