



      ###########                    ##############
      #.........#                    #............#
#######.........#                    #............#
#.....#.........#                    #............#
#.....#.........######################............#
#..*..=....@....&.................................#
#.....#.........######################............#
#.....#.........#                    #............#
#######....*....#                    #............#
      #.........#                    #............#
      #####.#####                    ##############
          #.#
          #.#
          #.#
      #####.#####
      #.........#
      #.........#
      #.........#
      #....%....#
      #.........#
      #.........#
      #.........#
      ###########
