                                         #...#                                    #########
                                         #...#                                    #.......#
                                         #...#                                    #.......#
                                         #...#                                    #...*...#
                                         #...#                                    #.......#
                                         #...#                                    #.......#
                                         #...#                              #######=======#######
                                         #.!.#                              #...................#
                                         #...#                              #...................#
                                      ###########                           #...................#
                                      #.........#                           #...................#
                                #######.........#                           #...................#########
                                #.....#.........#                           #...................#.......#
                                #.....#.........#############################........B..........#.......#
                                #..*..=....@....&......!........................................&...%...#
                                #.....#.........#############################...................#.......#
                                #.....#.........#                           #...................#.......#
                                #######.........#                           #...................#########
                                      #.........#                           #...................#
                                      #####.#####                           #...................#
                                          #.#                               #...................#
                                          #.#                               #...................#
                                          #.#                               #########...#########
                                      #####.#####                                   #...#
                                      #.........#                                   #...#
                                      #.........#                                   #...#
                                      #.........#                                   #...#
                                      #....%....#                                   #...#
                                      #.........#                                   #...#
                                      #.........#                                   #...#
                                      #.........#                                   #...#
                                      ###########                                   #...#
                                                                                    #...#
                                                                                    #...#
                                                                                    #...#
                                                                                    #...#
                                                                                    #...#
                                                                                    #...#
                                                                                    #...#
                                                                                    #...#
                                                                                    #...#
                                                                                    #...#
                                ########################                            #...#
                                ###...##........##...###                            #...#
                                ###...##........##...###                            #...#
                                #......=...............#                            #...#
                                #...*..=...........*...#                            #...#
                                #......=...............#                            #...#
                                ###...##........##...###                            #...#
                                ###===##........##...###                            #...#
#################################......................#                            #...#
.........................................M.............#                            #...#
.......................................................##############################...#
......................................................................................!.#
........................................................................................#
.......................................................##################################
.......................................................#
#################################......................#
                                ###===##........##===###
                                ###...##........##=.=###
                                #......=........===.===#
                                #...*..=........=..*..=#
                                #......=........===.===#
                                ###...##........##=.=###
                                ###...##........##===###
                                ########################
