                                        #########
                                        #.......#
                                        #.......#
                                        #...*...#
                                        #.......#
                                        #.......#
      ###########                    #######=#######
      #.........#                    #.............#
#######.........#                    #.............#########
#.....#.........#                    #.............#.......#
#.....#.........######################....B........#.......#
#..*..=....@....&..................................&...%...#
#.....#.........######################.............#.......#
#.....#.........#                    #.............#.......#
#######.........#                    #.............#########
      #.........#                    #.............#
      #####.#####                    ######...######
          #.#                             #...#
          #.#                             #...#
          #.#                             #...#
      #####.#####                         #...#
      #.........#                         #...#
      #.........#                         #...#
      #.........#                         #...#
      #....%....#                         #...#
      #.........#                         #...#
      #.........#                         #...#
      #.........#                         #...#
      ###########                         #...#
                                          #...#
                                          #...#
                                          #...#
                                          #...#
                                          #...#
                                          #####
