                                               #########
                                               #.......#
                                               #.......#
                                               #...*...#
                                               #.......#
                                               #.......#
      ###########                           #######=#######
      #.........#                           #.............#
#######.........#                           #.............#########
#.....#.........#                           #.............#.......#
#.....#.........#############################.....B.......#.......#
#..*..=.........&......!...............@..................&...%...#
#.....#.........#############################.............#.......#
#.....#.........#                           #.............#.......#
#######.........#                           #.............#########
      #.........#                           #.............#
      #####.#####                           ######...######
          #.#                                    #...#
          #.#                                    #...#
          #.#                                    #...#
      #####.#####                                #...#
      #.........#                                #...#
      #.........#                                #...#
      #.........#                                #...#
      #....%....#                                #...#
      #.........#                                #...#
      #.........#                                #...#
      #.........#                                #...#
      ###########                                #...#
                                                 #...#
                                                 #...#
                                                 #...#
                                                 #.!.#
                                                 #...#
                                                 #####
                                            
