                                                  #########      
                                                  #.......#      
                                                  #.......#      
                                                  #...*...#      
                                                  #.......#      
                                                  #.......#      
                                            ##########=##########
                                            #...................#
                                            #...................#
      ###########                           #...................#
      #.........#                           #...................#
#######.........#                           #...................#########
#.....#.........#                           #...................#.......#
#.....#.........#############################........B..........#.......#
#..*..=....@....&......!........................................&...%...#
#.....#.........#############################...................#.......#
#.....#.........#                           #...................#.......#
#######.........#                           #...................#########
      #.........#                           #...................#
      #####.#####                           #...................#
          #.#                               #...................#
          #.#                               #...................#
          #.#                               #########...#########
      #####.#####                                   #...#        
      #.........#                                   #...#        
      #.........#                                   #...#        
      #.........#                                   #...#        
      #....%....#                                   #...#        
      #.........#                                   #...#        
      #.........#                                   #...#        
      #.........#                                   #...#        
      ###########                                   #...#        
                                                    #...#        
                                                    #...#        
                                                    #...#        
                                                    #...#        
                                                    #...#        
                                                    #...#        
                                                    #...#        
                                                    #...#        
                                                    #...#        
                                                    #...#        
                                                    #...#        
                                                    #...#        
                                                    #...#        
                                                    #...#        
                                                    #...#        
                                                    #...#        
                                                    #.!.#        
                                                    #...#        
                                                    #####        
                                                
                                                
